3=trash
A=Aksana
#A=Layla
B=Bella
D=Candice
E=Eve
F=Funkadaktels
#G=Gail Kim
G=groups
H=hair
I=Melina
J=AJ
#K=Stacy Kiebler
K=Kelly Kelly
L=Lilian Garcia
#M=Maria
#M=Marlena
M=Melina
#M=McCool
#M=Mickie James
#M=misc
N=not good
O=earrings
P=hips
P=lips
R=Trish Stratus
S=Sable
#S=Sunny
T=Tiffany
#T=Torrie
V=navel
W=wwe
X=spandex
# mouth
U=lips
Y=Maryse
Z=Rosa Mendes